11111111111111111111111111
10000000000000000000002001
10242000000003000000000001
10000000000000000000000001
10000000000000000300000001
11111111111111111111000001
10000000000000002000000001
10000000000000000300000001
10000000000002000000200001
10000000000000000000000001
10000011111111111111111111
10003000000000000000000001
10200000020000000000000001
10000000000000000300000001
10000000000000000000000001
11111111111111111111000001
10000000000000000000000001
10030000002000000000000001
10000000000000000000000001
10000000000000030000000001
10000011111111111111111111
10000000000000000000000001
10000003000002000000000001
10000000000000000000000001
10000000000000000000000001
11111111111111111111111111