11111111111111111111111111
10000000000000000000002001
10242000000300000000022001
10000000000000000000000001
10000000000000000000000001
11111111111111111111000001
10000000000000002000000001
10000000000000000020000001
10000000000002000000200001
10000000000000000000000001
10000011111111111111111111
10000000000000000000000001
10200000220000000000000001
10000000020000000000000001
10000000000000000000000001
11111111111111111111000001
10000000000000000020000001
10000000002000000000200001
10000000000000000000000001
10000000200000000000000001
10000011111111111111111111
10000000000000000000000001
10000000000002000000000001
10000000000000000000000001
10000000000000000000000001
11111111111111111111111111