11111111111111111111111111
10000000000000000000000001
10202000000000000000000001
10000000000000000000000001
10000000000000000000000001
11111111111111111111000001
10000000000000002000000001
10000000000000000000000001
10000000000000000000000001
10000000000000000000000001
10000011111111111111111111
10000000000000000000000001
10000000000000000000000001
10000000000000000000000001
10000000000000000000000001
11111111111111111111000001
10000000000000000000000001
10000000000000000000000001
10000000000000000000000001
10000000000000000000000001
10000011111111111111111111
10000000000000000000000001
10000000000000000000000001
10000000000000000000000001
10000000000000000000000001
11111111111111111111111111